#########################################
#.#.................#.......#...........#
#.#.###########.###.#.#####.#.#######.###
#.#...........#...#.#...#...#...#...#...#
#.###########.###.###.###.###.###.#.###.#
#...........#.#.#.....#...#...#...#.....#
#.###.#####.#.#.#######.#.#.###.#######.#
#.#.#...#...#...#...#...#.#...#.#.#.....#
#.#.###.#######.#.#.#.###.#.###.#.#.#####
#.#...#.#.....#.#.#.#.#...#.#...#.#.#...#
#.###.#.#.###.#.#.#.#.#####.#.###.#.#.###
#...#.#...#...#.#.#.#.....#.#.#...#.#...#
###.#.#####.###.#.#######.#.#.#.###.#.#.#
#...#.#...#.....#.......#...#.#.....#.#.#
#.###.#.#.#############.#####.#.#######.#
#.#...#.#.........#...#.....#.#.........#
#.#.#.#.#.#######.#.#.###.#.#.#########.#
#.#.#...#.#.....#.#.#.....#.#.#.......#.#
#.#######.#.#.###.#.#.#######.#.#####.#.#
#.........#.#.......#.#...#...#.....#.#.#
###########.###########.#.#.###.###.###.#
#...#.......#.....#..O#.#...#.....#.#...#
#.#.#.#######.#####.###.#########.#.#.###
#.#.#.#.#.........#.#...#.......#.#...#.#
#.###.#.#.#######.#.#.###.#####.#.#####.#
#.....#...#.....#.#.#.#...#.....#...#...#
#.#####.###.###.#.#.#.#.###.#######.###.#
#.#...#...#.#.#...#.#.....#.#.....#.....#
#.#.###.###.#.###.#.#.#####.###.#######.#
#.#.....#...#...#.#.#.#...#...#.......#.#
#.#######.#####.#.#.#.#.#.###.#.#.#####.#
#...#.....#...#...#.#.#.#.....#.#.....#.#
###.#.#.###.#.#.###.#.#.#######.#####.#.#
#.#.#.#.#...#.#...#.#.#.#.....#.#.#...#.#
#.#.#.###.###.#####.#.#.#####.#.#.#.###.#
#.#.#...#.#.#.......#.#.....#.#.#.#.....#
#.#.###.#.#.###########.###.#.#.#.#######
#.#...#.#...#.........#.#...#.#.#...#...#
#.###.#.###.###.#####.###.###.#.#.#.#.#.#
#.........#.....#.........#.......#...#X#
#########################################
