########.###.##.##..##..#...##..##..####.##...##..#.#.#####....#....##..##.##.##..#.##...##..#...##...#.#.####...#.###..#..#.#....####.........#.....#.....#..#.#..#..##..######..#.#.###..#...#.##....#.##.##..###.##.#..#..#####..##..##.....#.##.######..#.#...#..#.....#..#..##...##.#.###....#.#.#.#.####.##.####.##.#.#.....##..##.#...####....#..#..##.#...#..#.##.....#.#.##.###..#.#........#.#######..#..#..##.########........###.############...#...##.#######.##.########..#...#..#........#...###.#.##.#..#.####..

...#....##.###...##.#..#....#.###.##.....#..#...###....#.###..###.##.#.#.#.....#....#...##...#..#..#
.#...#.#.#.####..#...#..#.#..###.##..#.####...#....###..###...#.##.#...#....#.#..##.#....#...####.#.
#####.#.#..##..##..#.#.###.#..##.##.##.##.....#..#....#.#.##.#.##.#..#.####...#.#.##..##.####..##..#
...##.#...######.#..##..###...##..#.##.##.#..#####.##.#..##..#.#####.##...#.#.#..##.#.#......#..##..
##.#...#..#.#.#....#..#.##.###..#...#.#.....###.#...###.#....#.##..###.#..#.##..#.##.#..#....##..###
..#...##.#####..#.#.###....##.#.#..#.###.##.#####.##.....##...#......#..#.###.#.....###...####...#..
.##.##.###.#.#...#..#####...#..##.#.#.##...#.##.#.#..###.#.####......#.#.##..#...#.##..#####...##..#
....#.#..#.......#.#.#..###.####.#.#.#.###...##..###..#.######...####..###....##.#...##.#..########.
...........#....###.#...##.#.##..##..##...#.#...###.#..###.#.......#........#.##..##.....#.##.#.###.
.##.##..##...#.#.#...#.#.##.###.##..#.##.##.....######.##.....#....##....#..##.#....#..#######......
#........####.#....#####.#..#..##...#.#.#####.#....##.#.##.##...#.#####.......#..###.#.###.####...##
..####..#.#....######..###.#......##...#####.####.#.#.#######..#.###...##..#..#..##.#...#.....##.###
####.#...####.##...#...#####...#######...#.#.##.#.##......##..###.#.#.##.#.###...#..#.###.##..##.#..
..#.#...#.#.....#.#.##.###..##..#.#.##..###.....#..##......###.......#.##.##...####.#...###.....#...
..##.######.#...#..##.###.#.#.....##......#..#......##.###.###.#.....#.#..##.###.#.#.#...#.#.###.#..
##.#.#.###.#.##.#..####..##..#...###.#####.###.####.#.##.#..#.##.######....#.#.#...#.#.#......##..#.
..###.#.##########.##...##..#.###.#...##...##..#...#..#.##.#....##.######...####....####.#...##.#..#
####...#.#...#.#..#.#.#.....#.#.#..##....#.....###..#....#..#.#.##.#...#..#.###.#..##.#..##.#....#..
##.####.#....#.##.#.#..#####.#.......#.####..#.#...###....###.#.###.#..#.###.#..####.#...#.#..#.#...
#.###..#...###.#.#.####..#.#.##.#..###.#####..#........#..#.....##.#.#...######.#..##....###.##.##.#
#..#.#..##.######.######.#.#.###...#....###.##..#.#.#.##.##..#.#...#..#..###....#......##...#######.
#.####..#..##.#.###.#..##...####..#.##.#####..##.#..####..#.#..#.##..###...#..#..#.###.######.####..
..##..#.##...#..##....#..##...##..##..#.###.#.###....##..###.........#..#.##.#..#......#.#####.##.##
#.##........####..#....#..#..####.######..#.######.......#.###.#.##...#.#..#.#.#.#####.#.##....#...#
#.#.#......#.##.#.#....#.#..#.#.##...#...###..###.#.#...##...#....#.#.#..###...#.#..##.#.##.#....###
.#....#####.#...##.#.########...###.#####.#.#....####..#.#...###.##...#..#.#....#.##..#.#.#####.#...
.#..##.#......##.####..##..#..##....##.##.###..#..##.#...####..##...##...#..#...####..####.#.#.##.##
.#...###..####..#.##....##.#..#...###...#.#..#.#..##.....##...#.##...#.#.######.#.##.....#.###......
...#.#....#..############.##...#.#...##..###..#..#.##.####.###.#.##..##.###..#..###.####..#....####.
....###..#.##.####..#...##.##.###...#..#.#.##.#..#.#.##..#..........#.##....#.###.#######..##.#.#.##
###.#.##.##.#####..#.###.#.#.#.#####.#.##...##...#.#.#############....####.###....#####.....#..##.##
#######.#.....####.#..#.###..##...##.#..##.....#.##.....########....#..##.####.###..#..##......#..##
...#.#.#...####.#.###.......#...##..###...##...####.#...###..##...#..###.##.#####.####.#...#...#####
##.##.#.#.#.#.....##.##.##.####.#.#...###..#..#....#...#..........##.###.#..#.###.######.##..#..#...
##...#..####..#.##.###...#.#.##..##.#.##..##...#.#..###...#....#....###.###.#.#.#####....#.###.#.###
.....##.#..#.######.#.#.##.###...#..#...#.....#.##.####..##..##.###.#########....#...#.#..##..###...
.#...#######.#..#.#..#.##########...##.#.##....########..#.####.#.###.##..#..#..#.#..#.#.#######.#.#
.#..#..#..#.##....#.....#.##.#.###.###..####..##..##..#.#.#.#.#.##..#.#..#.########.##.####...###...
##.#.#..#.#.#.#.#...#.###.#.####.####.#..##..#.#.#.####.#...#.###.#.######..#.#####.##..##..#..####.
##....#..#.####.#..#...#...########.#.#.#####.###.###..##..##.##.....#.....####.##...#.##.#....#..#.
.##.##...###...#.##.##...###.####.#..##.#.###.####.#.....####..#.##.##..###.##.#.#.#.##..#.....#...#
.##..####..#..###..#...##..#.........#...####.#.#######....##..#...#.....##..#.#.#..#.##.##.##..##..
##.###.###.##..####.#......#.#....#.####.#####....#.#.#....##.###...#.#...##.##...#####.#####..#.#..
####.##....##.###....#.#..##.#####.##.#.##..####...##...##.###.#..#.##...#.####.###...########......
###.####.##..#...###...######.###..##.#.#.#.#.#.#....#.####...#..#.....##...#.##...#.#..#.#......##.
...##..#....#.#...#..##....#.....##..#.#...#.###.#..#.#..#......##.##..#.##....####.#..#.###...##...
##..#.##...#..##....#.#.....#..#.###........###...#..######...#..###...##...####.#.#..##.###.......#
.###...#.###...#..####.#.##.##.##...#...#..##.#....##....###..#...##..###...#....##.#...###..#.#.###
...#..#..#.#...##.##.##...#####.#.######..#..#...##.#...#.#....###.#.#.####..#....#..#.#..####...#..
#...#..####.##.##....##.#.#.##.#.......###.#.##..##...#.#..##.#.####.#..##.##...#..#.###..##.......#
###..##.#..#.#...#.#......#.##.#.##..#..#...#....#.....#..##..#..#..###.#..#...#.#.....#.###......##
#..##.#####.#.##.####.......#.#..#.##...#.#.#....#.#.######...##...##...####.#..#..#.###.#.#...####.
....#.#.##.#.##.#.##.###.#.###..#####.#.###.##..#.#..##....###...##...#.#..#.##..####.###.######.#.#
..###.##.....#.#.####.##.#.#.##.#####...##.#.##.###.#..##.###.#.###.........##....##.#.##....#.##...
##...#.#..#.#.#.###.###.#...#.#..#..#...###.###..####....####.........#..#####.##..#..##...##.##...#
.#..#..#.##.###.#...#...#...#.##...#...##....###.......#.#####..#..###...######..##..##.##.#.#.###.#
..#...#.##.##.####....##.#..#.##.##.#.##.#.#...#.#.#####......###...#..#.#...#.#..###.####...##.#.#.
.#.....##.#######..#...#.#.##.#.#...#.....##.#.......##......##.##..#.#.#.##..#.##..##.#.##..##.#..#
###.##..##.###.##..#.#.#.#.#.##......##..##...#.##..##.#.####..###.#...#....##.##.#.#...#.....#.##..
###..#...#..##.##..#.#...######...#.###..###..##.##...#..###.....#...####...#..#...#.##.#.###.......
#...###.#...#####.#.##...#...#.....###..#..#.##.##.###....##.#..#.....#..#.##.#..####.##.....##.#..#
#..##...##..###......#####.##.#.#..##.##.##..#.......#..#.###.#...##..#####.####.#.....#.###..###.##
...#.......#.#..######..####.....##.###..#####..##....#..#.#...#..##.#....###.#..........###.#.#.#..
.###...#.##..#.#...#..##..###.##..#.#.##.#.#..#.#..########..#.#.#...#.##..#...###...##..##..##.####
.#####....##..#.####.#..#..#.###.####....#..#...#.#.##.#..##..#.###.###...#...#....##.....##.#..###.
.#..###.##..###......#.#.##..#########.#.###............##.##......#####.#..#..######..#....#.##.##.
.##.......####..###..###...####..#..#####.####..##.....#.###..#.##..##.#.#....##...#..##....##.#.###
###.###.#..#.##....##.#..#..#..#..####.#.#.##.#.##.#.#####.#..#.#.#####.####.##.#.####.....#.#.#####
##..#.####..##.####.#####..##.#..###..##.##.....####.##..##..#.#..#......##.###.#..########.#.#..#..
####..###.#.######...####.###..#.#....##.#.#.##.#.#.#.##.#....#.####.#.#.#####.......##.#...##.##...
..#..##.#.##.#.....#.#.##.#.#.#####......##.##.##.####....####.#.#.###....##..#..#.#####.##...##.#.#
....##..#..#.#.#.##.##.#.###..#.###.....#.##.#.##.#.###.#....#.....#....#####.....#.##...#.##....###
###.#.##.###..###...#...#...#.....#..##...##.###.#..##..##.#.#.#######.....#..#.#.#.####.#.#...###.#
.##.####.#.##..#.#....###..#.##.#.....##..##.##.....###..##.#...####.##.#.#######.###........#.#.###
......#.##.######.##...##.#..##..#.#####...###.#....###.######.#####...#.#..##..#.##....#..#....#..#
##...#....#..##..##.#.##.#.#...##.##.#...##.##.##..#..#...#...##..####..######..#..#.###...#..#..#..
....#..#...#.#.###....#..#.#.......#..#.###..#######.##.#.####.#..#.#.#..##....#..#.##...#.###.####.
..###..##.#...##.##....####.##..##.##.##.##...###..##.#.#....##.##...##.....##..#.###.#.##..#######.
#.##........##....#.#..#..#..#.#.###..#.##.#.#.###...#.##...#....###..##.#.#..#.###.#..##..#.#...##.
##......#...#.#...###..........#...##.#..######...#.....#.#.##.###.#.#.#.##.###.#....#..#.##.##.#..#
#..#####...#.#..###..#..##.##..##...#.##...#.###.#..#.#..##.###.####.##..##.##...##..#.##.#...#.####
##.###..#.....###.#.#.#..#..##.#........#####.#..#.####.#..##.##..#.##...#.#...#.#.##.##..#.###.###.
#####.#..#.##...#.###..#####...#####..##..#..#..#####..###.####.#...#...####..##.###....##.##.###...
##.####.#..#..##.#..#..###...####.##..#.#..#.##.#.###.#..#.#...#..##.#.#..#######.##.#..##..###...##
##..##.....##..#####..#...###.##.###.####.###.##.#.########...#.#.####..###.##.#..##########.#.....#
#.#.##...#.#...##.##..#.#.#...#.#.##.#.###.#...##...##.....###.#..#.#..####.#..#.#######.##.#.##.##.
##.#..####.#.....#.#..##.##...###...#..#.##.##..###.#####.##....#.#..#...#####...#.##..#.#..#....#..
##.###.##.#...#.##.....##..###..#.#..###..##.###.....#...#...#.##.#....#..#...####.#..#..#.#.#.#.###
.####......###.#........#..#..#....###.#.#.....#..#...###.####.#...###.#..###.#.#...###...###..#####
##.#.###.#.#.#..##.##.###.######...#.#.##..#...##..#...##.#.##..#.#..#.##.#.#.##.##.#..####...#.#...
##.......#.##...#.#.....##..#.#..#...#..#..#..#..#.#.###.##.#.#.#########.#.####...##......######.##
....##.#.##.##.#.#.#.#.##..####....#..###.#..#.##...####.....##.#.....#####.##.......##.##.#..###.#.
.#####..##...###.##.#.....#......#..#.#..#.#..#......##..##.##..#..##.....#...##.#....#..##..#..##.#
#.###..##...###....#.###.#.#.##..#....##...#..#.######....##.#....##...####.###.#####..##......#...#
##..#.#...#####..##.#.###..##..#.#.####..#..#.##.#.#.#..#.##..#.###.#####.##..#...#..#.###..#.##...#
#.#...#######..#.####...##.#.#######..####..#.###...####.####..#...#.#....#..#.##...#.##.#..####.#.#
#...#.##......######.#.####..####.#.#..#.#..#####...##..#.##.###.#..#.####.###.##..#..####..####....
###.###..#.......###..#..#.##...##.###..#...###.#....#...###.#.#.#.#...#....#.##..##.########.##....
.#.....##.....#.#.####......#.#.#..#######.#....#.....###...###.##...#..#..##.###.#...#..###.#.#####
##..#..###.##...#...#...####..###...###.#.#..###.#####...#####..#####..#.#.####.##.#....#.####..####